NO ./img/north.xpm

WE ./img/weast.xpm

EA ./img/east.xpm
C 0,150,255

SO ./img/south.xpm

F 160,100,0


        1111111111111111111111111
        1000000000110000000000001
        1011000001110000000000001
        1001000000000000000000001
111111111011000001110000000000001
100000000011000001110111111111111
11110111111111011100000010001
11110111111111011101010010001
11000000100101011100000010001
10000000000000000011000000101
10000000000000001001010010001
11000001110101011101011111N01
11110111 1010001 100010010001
11111111 1111111 111111111111